
NO ./textures/neon1.xpm
WE ./textures/neon2.xpm
EA ./textures/neon4.xpm

C 102,0,102
SO ./textures/neon3.xpm
F 0,0,5




  1111111
  1000001
111011111111
10001  11001
100011110011
100010100111
10101111111
11101111
100N0001
10100011
10000111
11111111